###############
#.............#
#.###.#######.#
#.###.##......#
#....@##.####.#
#.###.##...#..#
#.###.####.##.#
#.............#
#.#.#.#########
#.#...........#
#.######.####.#
#.............#
###############
