#######################
####...#######.####...#
#....#............#.#.#
######.####..##.#.#.#.#
#......#...@....#.#.#.#
###....#.#####..#.#...#
#.....##.....#..#.#.###
##.####.####.#..#.#..##
##.#.......#.####.##.##
#..#.####....####....##
#######################
